Heelo Codevval | Hello Codeeval
hELLO cODEEVAL | Hello Codeeval
Hello Codeeval | Hello Codeeval
THIS IS A TEST | this is a test
qIPyXmsnoJVKYzBUIzZQVTjF khQkd oP s | hUYnI  ITJsomkK qzVQVFkjXPPzyodsBZQ
ZzEFLedllgShDfoGe | edZEDeLfzogllFGSh
xGAm DvFgUlWMSvinGGFajVYrLfryBeEfDyjaqar | EvrYmaGrfBSnraDyleaWAqLMGyVxgjG FUDifjFv
A mwTebPZkfzKnPVVUkocrJiwOqNOpRwKwkvCk | fPvkJORnwOVkkArwwNUbcPiToVmzqep kCKKwZ
OPtIaUPAvrrwqJKegJlFBjOcScQXgZ | OPaQrqrgcvJKUStjPeIXAlwFBOgcZJ
jxYsdaEfPDMKPgVwpaAFaRm | EgmYMDPAfPFKRaxVawasdpj
Hello Codeeval | Hello Codeeval
xZhFlozztGiqLsJXkmsSnAyH | tlssHimyXFSkozAnxzqhZJGL
PaIHKRPAUYiRYGyqXH cAaqDybmqls | AyslKGRqUmqcIqyaPRDYXbAHPiHaY 
CJmFuc Dzd wKDcjyEWOjQDgCiXJzufgkxQD | WxJcyCzdFEgKfgXk ODcDQDCiwz uujJQDmj
Gbuyxnz vkQxa |  kuQnzaxGxbvy
BBTcXhDjzu | XjBDcBhzuT
NUgksTRrUcdAPJ | PUckrsNUTAJgRd
vXy Kmk |  vXkmyK
zUmsnebaqLVUVpHOfwXqiGrZZCKGJnC | HCZrzJZGawbKVCfnqVGqeUnsXUmpOiL
hELLO cODEEVAL | Hello Codeeval
GiPzDPHrjgrzuXtZWFlYnGJO | inWDPYzuGHZtGPlFgrJrjzXO
fHzncAzFwmIKKQZIhzRWyAbYKtPLODddBWFA | zndOWIhFIHcwYyAfZBtbzAFWKRDPzLQKAmKd
L AaKLxQBS JBDrowtk |  xDKSJLroQkaALwt BB
TJGeXxHtBqn | eHGBXTnJqtx
FUYDGxMpvCkIJssCmhWHNKHKACkktGhM | CGCGxhHNACDHtmJsYMhWsvIUFpkkMKKk
ZSrbJrYW | bSWYrZrJ
FiDXkQRWbBLlBceBerY | erWblDRBBBeYkQcXFLi
xpjilpExMYYLRSKBYYZrBuRUUK J | iYu rBKxYpJUxRERZlBYSpYjMKUL
FASTXTKBMnjoRwAQZQQNEGGQ | KTQjTGQZRANBGMwQFnQEXSoA
EmEbExoRzVzbFJLhx | oVzEFxxELEzbbmJRh
tHEtjfqz eURYMJucljBLgLPR | tRf cejguEqYjHBLMtPlRLJzU
Heelo Codevval | Hello Codeeval
VoNNS QKEIkLZxssyqwMDaJpQVTas | ZspTNsDIVx aJkEosMSQyaNQwKqLV
EUEdm ekmsMVzRvuumSEM | zU VsEuSRMMumEedEmvmk
BNKtnVbFYz | VzbFYnNKtB
mRiDTjbztFPfpk | mfTtkbPjiDRpFz
 StMrjtQpzUTGcVHgwsoQu diYAGzuaavl | icjQMatGHTYzuVGsgUzo puAtwvdQlSa r
RxFEOmqDDnJHvBBD | RDHnDEmOvqFxJBDB
BlQfNIlOpTuwC | upwBQllfONCIT
ugzFwUYCJbBFJCoMsBhC | oMJCsgFJbBwhCBUuFzCY
fzvnqoRZMHebeVCLtvriLTVwCKpqiUcDSNxz | fCUiTNVzDbevvrxMziSRLpcHwKotqVnqCeZL
bmkTs IcBHk fcnipitgRQcOnhvY | fkcnk nBhsIYpRtTHcbOmQgiv ic
gNsEcVXAVjasAK RczfMlDnVBV YW | EcgVnVczANfKVDXjVYA ssW MBalR
TxuiXvcWNyOPCTxnJmfivjPb | iPxvcTjiNnbyxmTJPuOCXfvW
